timestamp,mallcode,type,volume,male,female,weight-child,child,weight-student,student,adult,total
2014-06-17T19:52:50.074,IMM,2,25,24,1,4,1,56,14,10,25
2014-06-17T19:45:25.076,WESTGATE,0,26,10,16,19,5,49,13,8,26
2014-06-17T19:44:28.998,WESTGATE,1,27,3,24,10,3,30,8,16,27
2014-06-17T19:40:45.348,JEM,0,6,1,5,22,1,14,1,4,6
2014-06-17T19:39:16.665,JCUBE,1,6,2,4,2,0,24,1,4,6
2014-06-17T19:36:38.068,JEM,1,5,2,3,10,1,19,1,4,5
2014-06-17T19:18:45.724,IMM,1,40,19,21,29,12,49,19,9,40
2014-06-17T19:16:55.737,WESTGATE,2,6,0,6,2,0,26,1,4,6
2014-06-17T19:15:05.884,IMM,0,43,18,25,37,16,30,13,14,43
2014-06-17T19:09:38.454,JCUBE,1,8,2,6,27,2,35,3,3,8
2014-06-17T19:05:55.324,JEM,1,19,6,13,1,0,23,4,15,19
2014-06-17T19:03:45.107,JCUBE,2,7,1,6,32,2,7,1,5,7
2014-06-17T18:59:05.698,IMM,2,5,0,5,24,1,50,3,1,5
2014-06-17T18:54:06.179,WESTGATE,2,5,5,0,4,0,55,3,2,5
2014-06-17T18:52:31.189,WESTGATE,2,14,11,3,3,0,9,1,12,14
2014-06-17T18:33:30.502,JEM,2,7,2,5,15,1,46,3,3,7
2014-06-17T18:29:58.478,JCUBE,2,14,2,12,12,2,15,2,11,14
2014-06-17T18:20:20.85,JEM,1,5,5,0,25,1,37,2,2,5
2014-06-17T18:13:16.722,IMM,2,13,0,13,36,5,36,5,4,13
2014-06-17T18:11:36.541,JEM,1,5,0,5,22,1,5,0,4,5
2014-06-17T18:06:20.225,WESTGATE,2,5,1,4,5,0,36,2,3,5
2014-06-17T18:04:26.377,WESTGATE,2,5,5,0,15,1,56,3,1,5
2014-06-17T17:54:42.529,JCUBE,1,5,4,1,39,2,6,0,3,5
2014-06-17T17:52:15.396,JCUBE,1,12,7,5,10,1,29,3,7,12
2014-06-17T17:44:41.781,JEM,1,152,118,34,28,42,32,49,61,152
2014-06-17T17:43:49.65,JEM,0,5,2,3,28,1,2,0,4,5
2014-06-17T17:41:50.093,IMM,1,207,166,41,17,35,9,19,153,207
2014-06-17T17:39:34.524,WESTGATE,0,13,2,11,27,3,21,3,7,13
2014-06-17T17:32:49.654,JCUBE,1,7,5,2,3,0,26,2,5,7
2014-06-17T17:29:57.879,IMM,2,52,39,13,22,11,18,9,31,52
2014-06-17T17:28:50.797,IMM,0,24,12,12,6,1,0,0,22,24
2014-06-17T17:24:00.363,JCUBE,0,8,2,6,1,0,6,0,7,8
2014-06-17T17:15:13.251,JEM,1,10,7,3,2,0,39,4,6,10
2014-06-17T17:13:12.025,JCUBE,1,8,5,3,3,0,10,1,7,8
2014-06-17T17:10:58.616,JCUBE,2,13,9,4,26,3,51,7,3,13
2014-06-17T17:03:42.909,WESTGATE,2,5,2,3,21,1,57,3,1,5
2014-06-17T17:02:39.761,IMM,0,12,4,8,35,4,50,6,2,12
2014-06-17T16:53:49.994,IMM,1,5,5,0,30,2,35,2,2,5
2014-06-17T16:52:35.997,JCUBE,1,5,0,5,21,1,44,2,2,5
2014-06-17T16:48:36.28,IMM,2,11,3,8,17,2,18,2,7,11
2014-06-17T16:42:52.635,JCUBE,2,42,5,37,1,0,9,4,38,42
2014-06-17T16:38:08.702,WESTGATE,0,5,1,4,31,2,42,2,1,5
2014-06-17T16:32:22.853,WESTGATE,0,5,0,5,37,2,0,0,3,5
2014-06-17T16:27:09.459,JEM,1,8,8,0,32,3,3,0,5,8
2014-06-17T16:07:52.423,JCUBE,0,20,7,13,5,1,39,8,11,20
2014-06-17T15:59:10.264,WESTGATE,1,5,2,3,32,2,22,1,2,5
2014-06-17T15:54:15.213,JEM,1,5,2,3,14,1,20,1,3,5
2014-06-17T15:53:35.351,JCUBE,0,13,6,7,3,0,54,7,6,13
2014-06-17T15:51:52.687,JEM,0,6,5,1,32,2,5,0,4,6
2014-06-17T15:50:38.208,JCUBE,0,239,116,123,40,96,14,34,110,239
2014-06-17T15:49:32.834,JCUBE,1,6,5,1,4,0,8,0,5,6
2014-06-17T15:46:19.733,WESTGATE,1,7,1,6,22,2,5,0,5,7
2014-06-17T15:42:38.752,JEM,1,8,5,3,31,2,51,4,1,8
2014-06-17T15:40:28.523,JCUBE,1,26,9,17,38,10,26,7,9,26
2014-06-17T15:39:20.127,IMM,0,50,33,17,2,1,4,2,47,50
2014-06-17T15:38:02.22,JCUBE,2,11,8,3,33,4,37,4,3,11
2014-06-17T15:24:10.695,JEM,0,10,7,3,40,4,12,1,5,10
2014-06-17T15:21:54.538,IMM,0,5,3,2,40,2,17,1,2,5
2014-06-17T15:16:11.324,IMM,1,5,1,4,16,1,53,3,2,5
2014-06-17T15:09:12.466,WESTGATE,2,5,1,4,38,2,18,1,2,5
2014-06-17T15:07:18.171,JCUBE,0,7,1,6,20,1,6,0,5,7
2014-06-17T14:56:22.605,JEM,0,5,2,3,37,2,46,2,1,5
2014-06-17T14:54:41.953,IMM,2,7,2,5,34,2,44,3,1,7
2014-06-17T14:51:37.053,JCUBE,1,9,7,2,2,0,12,1,8,9
2014-06-17T14:45:24.557,JEM,2,5,2,3,25,1,29,1,2,5
2014-06-17T14:43:34.09,IMM,1,11,1,10,39,4,11,1,5,11
2014-06-17T14:40:39.343,IMM,2,37,11,26,14,5,7,3,29,37
2014-06-17T14:35:32.893,IMM,2,5,3,2,6,0,53,3,2,5
2014-06-17T14:31:29.132,JEM,2,10,5,5,15,2,55,6,3,10
2014-06-17T14:27:40.975,JEM,2,8,1,7,34,3,3,0,5,8
2014-06-17T14:22:43.02,IMM,1,6,2,4,34,2,5,0,4,6
2014-06-17T14:21:29.967,IMM,2,9,5,4,2,0,8,1,8,9
2014-06-17T14:16:29.056,JEM,1,14,4,10,18,3,12,2,10,14
2014-06-17T14:13:43.068,WESTGATE,1,23,12,11,29,7,31,7,9,23
2014-06-17T14:10:45.393,JCUBE,0,15,2,13,0,0,26,4,11,15
2014-06-17T14:09:18.031,IMM,1,313,196,117,10,31,42,131,150,313
2014-06-17T14:00:54.886,JCUBE,0,26,6,20,35,9,41,11,6,26
2014-06-17T13:57:00.458,JCUBE,1,11,8,3,36,4,15,2,5,11
2014-06-17T13:52:06.489,JEM,0,13,5,8,20,3,48,6,4,13
2014-06-17T13:45:59.89,WESTGATE,2,5,1,4,37,2,4,0,3,5
2014-06-17T13:42:55.144,JEM,1,7,1,6,8,1,28,2,4,7
2014-06-17T13:41:44.389,JEM,0,39,19,20,9,4,0,0,36,39
2014-06-17T13:38:58.42,IMM,2,18,9,9,30,5,51,9,3,18
2014-06-17T13:37:07.757,JEM,1,5,5,0,12,1,2,0,4,5
2014-06-17T13:32:07.908,JCUBE,2,14,1,13,37,5,40,6,3,14
2014-06-17T13:31:38.6,IMM,2,20,3,17,3,1,26,5,14,20
2014-06-17T13:30:26.751,JEM,2,6,5,1,23,1,48,3,2,6
2014-06-17T13:26:23.637,JEM,1,14,5,9,28,4,52,7,3,14
2014-06-17T13:21:13.784,JCUBE,0,6,4,2,39,2,10,1,3,6
2014-06-17T13:16:36.58,IMM,2,5,4,1,7,0,49,3,2,5
2014-06-17T13:13:54.496,WESTGATE,0,17,5,12,29,5,49,8,4,17
2014-06-17T13:09:39.843,JCUBE,2,6,0,6,37,2,24,1,2,6
2014-06-17T13:06:56,JCUBE,2,88,12,76,15,13,53,46,28,88
2014-06-17T13:06:24.972,IMM,0,11,5,6,9,1,3,0,9,11
2014-06-17T13:05:04.432,JEM,0,20,5,15,8,2,21,4,14,20
2014-06-17T13:04:39.258,JEM,2,26,19,7,38,10,37,10,7,26
2014-06-17T12:57:23.54,IMM,2,24,22,2,15,4,23,6,15,24
2014-06-17T12:53:48.299,JEM,1,5,4,1,22,1,47,2,2,5
2014-06-17T12:50:49.452,IMM,1,5,4,1,38,2,47,2,1,5
2014-06-17T12:48:12.977,JCUBE,1,5,4,1,1,0,34,2,3,5
2014-06-17T12:45:06.591,IMM,1,8,3,5,37,3,20,2,3,8
2014-06-17T12:40:29.723,JEM,1,14,0,14,0,0,6,1,13,14
2014-06-17T12:39:28.52,JEM,0,9,8,1,5,0,15,1,7,9
2014-06-17T12:26:45.386,WESTGATE,2,8,8,0,27,2,14,1,5,8
2014-06-17T12:20:58.786,WESTGATE,0,20,16,4,14,3,59,12,5,20
2014-06-17T12:12:56.692,JEM,0,25,7,18,2,0,18,4,20,25
2014-06-17T12:11:38.284,WESTGATE,2,22,2,20,38,8,52,11,2,22
2014-06-17T12:06:17.218,IMM,0,11,7,4,15,2,4,0,9,11
2014-06-17T11:57:19.352,JEM,0,8,3,5,23,2,2,0,6,8
2014-06-17T11:50:48.382,JCUBE,2,259,156,103,0,0,58,150,109,259
2014-06-17T11:49:30.634,WESTGATE,1,10,6,4,32,3,23,2,4,10
2014-06-17T11:46:16.315,WESTGATE,0,6,0,6,9,1,21,1,4,6
2014-06-17T11:44:54.446,WESTGATE,2,5,4,1,40,2,56,3,0,5
2014-06-17T11:42:25.526,JEM,2,5,5,0,33,2,28,1,2,5
2014-06-17T11:37:01.049,IMM,2,16,7,9,38,6,26,4,6,16
2014-06-17T11:32:53.563,WESTGATE,2,34,4,30,8,3,42,14,17,34
2014-06-17T11:30:39.411,JCUBE,0,5,0,5,19,1,55,3,1,5
2014-06-17T11:27:20.56,JEM,1,8,8,0,34,3,60,5,0,8
2014-06-17T11:21:58.48,JCUBE,0,29,6,23,38,11,27,8,10,29
2014-06-17T11:20:14.311,JCUBE,1,78,56,22,33,26,37,29,23,78
2014-06-17T11:18:53.799,JCUBE,2,9,0,9,2,0,27,3,7,9
2014-06-17T11:10:02.815,JEM,1,19,15,4,0,0,47,9,10,19
2014-06-17T11:08:51.016,JCUBE,1,10,4,6,8,1,29,3,6,10
2014-06-17T11:05:59.934,JCUBE,0,5,1,4,9,0,11,1,4,5
2014-06-17T10:55:54.574,JCUBE,0,5,3,2,34,2,23,1,2,5
2014-06-17T10:52:17.824,WESTGATE,1,5,5,0,27,1,4,0,3,5
2014-06-17T10:50:49.773,IMM,1,15,12,3,6,1,54,8,6,15
2014-06-17T10:46:04.979,JEM,0,8,8,0,37,3,52,4,1,8
2014-06-17T10:43:32.349,JEM,2,5,5,0,37,2,4,0,3,5
2014-06-17T10:41:33.257,JCUBE,2,30,3,27,23,7,55,16,7,30
2014-06-17T10:39:41.915,IMM,0,5,5,0,16,1,24,1,3,5
2014-06-17T10:36:51.71,JCUBE,0,12,6,6,32,4,49,6,2,12
2014-06-17T10:36:03.602,JEM,1,7,1,6,12,1,22,2,5,7
2014-06-17T10:34:18.407,WESTGATE,0,5,1,4,6,0,31,2,3,5
2014-06-17T10:33:36.805,JEM,2,129,58,71,4,5,31,40,84,129
2014-06-17T10:30:32.937,JCUBE,1,5,2,3,8,0,26,1,3,5
2014-06-17T10:28:08.794,IMM,0,7,3,4,24,2,7,0,5,7
2014-06-17T10:24:20.229,JEM,0,25,18,7,15,4,50,12,9,25
2014-06-17T10:18:18.453,JEM,1,5,5,0,13,1,18,1,4,5
2014-06-17T10:16:06.793,JEM,1,5,4,1,19,1,18,1,3,5
2014-06-17T10:12:31.801,IMM,0,13,7,6,13,2,48,6,5,13
2014-06-17T10:07:32.523,IMM,2,6,3,3,9,1,19,1,4,6
2014-06-17T10:06:33.111,WESTGATE,2,22,21,1,21,5,34,7,10,22
2014-06-17T10:04:57.228,JCUBE,2,8,1,7,5,0,43,3,4,8
2014-06-17T10:02:51.66,JCUBE,2,22,9,13,5,1,34,8,14,22
2014-06-17T09:58:54.066,WESTGATE,1,5,2,3,0,0,28,2,4,5
2014-06-17T09:58:09.003,JEM,0,8,6,2,1,0,1,0,8,8
2014-06-17T09:51:44.282,IMM,1,5,1,4,5,0,10,1,4,5
2014-06-17T09:50:38.934,WESTGATE,2,60,16,44,12,7,58,35,18,60
2014-06-17T09:47:50.519,JCUBE,0,7,7,0,7,1,27,2,5,7
2014-06-17T09:45:01.776,WESTGATE,1,10,3,7,22,2,50,5,3,10
2014-06-17T09:43:00.564,IMM,1,10,4,6,16,2,47,5,4,10
2014-06-17T09:39:19.237,JCUBE,1,10,0,10,27,3,46,5,3,10
2014-06-17T09:35:47.407,JCUBE,1,6,5,1,24,1,58,3,1,6
2014-06-17T09:33:40.806,IMM,0,51,35,16,39,20,32,16,15,51
2014-06-17T09:31:24.273,IMM,1,6,4,2,25,2,39,2,2,6
2014-06-17T09:26:56.012,IMM,2,24,8,16,15,4,33,8,12,24
2014-06-17T09:25:11.397,JEM,1,5,1,4,19,1,48,2,2,5
2014-06-17T09:21:15.99,IMM,2,16,6,10,23,4,28,5,8,16
2014-06-17T09:20:32.823,WESTGATE,2,5,1,4,23,1,40,2,2,5
2014-06-17T09:18:22.531,IMM,1,15,4,11,31,5,46,7,3,15
2014-06-17T09:15:26.431,IMM,1,8,0,8,40,3,41,3,2,8
2014-06-17T09:10:59.637,IMM,0,9,0,9,15,1,22,2,6,9
2014-06-17T09:09:10.394,IMM,2,12,11,1,0,0,31,4,8,12
2014-06-17T09:06:32.482,WESTGATE,2,9,4,5,6,1,41,3,5,9
2014-06-17T09:04:25.596,JEM,0,9,9,0,33,3,54,5,1,9
2014-06-17T08:58:39.68,JCUBE,2,20,5,15,28,5,26,5,9,20
2014-06-17T08:55:28.01,JEM,2,5,5,0,35,2,35,2,2,5
2014-06-17T08:49:27.296,WESTGATE,2,5,0,5,5,0,24,1,4,5
2014-06-17T08:49:12.852,IMM,1,186,140,46,2,4,2,4,179,186
2014-06-17T08:41:30.026,WESTGATE,2,15,2,13,28,4,13,2,9,15
2014-06-17T08:38:32.612,WESTGATE,0,13,8,5,0,0,46,6,7,13
2014-06-17T08:35:46.126,WESTGATE,2,5,2,3,9,0,44,2,2,5
2014-06-17T08:31:07.63,WESTGATE,0,6,1,5,17,1,34,2,3,6
2014-06-17T08:28:26.276,JCUBE,2,5,5,0,27,1,30,2,2,5
2014-06-17T08:26:55.005,JCUBE,0,12,5,7,30,4,7,1,7,12
2014-06-17T08:18:59.035,IMM,0,11,8,3,16,2,60,6,3,11
2014-06-17T08:13:36.253,JEM,0,16,4,12,25,4,32,5,7,16
2014-06-17T08:10:11.581,IMM,0,22,17,5,9,2,57,12,7,22
2014-06-17T08:09:28.228,JEM,1,31,21,10,20,6,48,15,10,31
2014-06-17T08:07:51.681,WESTGATE,2,97,44,53,15,15,35,34,48,97
2014-06-17T07:59:24.203,WESTGATE,2,7,1,6,26,2,5,0,5,7
2014-06-17T07:57:32.47,WESTGATE,2,14,11,3,1,0,33,4,9,14
2014-06-17T07:51:09.522,WESTGATE,1,5,3,2,39,2,19,1,2,5
2014-06-17T07:48:51.633,JEM,1,6,1,5,36,2,25,2,2,6
2014-06-17T07:36:33.448,WESTGATE,0,7,7,0,19,1,31,2,4,7
2014-06-17T07:30:52.48,JEM,2,51,13,38,12,6,31,16,29,51
2014-06-17T07:30:40.589,WESTGATE,2,7,0,7,4,0,28,2,5,7
2014-06-17T07:27:24.214,WESTGATE,1,52,20,32,25,13,36,19,20,52
2014-06-17T07:16:55.594,IMM,0,18,1,17,24,4,31,5,8,18
2014-06-17T07:11:12.111,JEM,0,8,3,5,10,1,44,3,3,8
2014-06-17T07:06:04.739,WESTGATE,2,5,4,1,1,0,2,0,5,5
2014-06-17T07:04:21.042,JCUBE,1,122,92,30,17,21,13,16,85,122
2014-06-17T07:01:49.786,JCUBE,0,11,9,2,35,4,51,6,2,11
2014-06-17T06:52:57.317,JCUBE,1,5,1,4,38,2,42,2,1,5
2014-06-17T06:49:18.292,WESTGATE,0,9,1,8,25,2,29,3,4,9
2014-06-17T06:45:07.728,JEM,2,8,7,1,10,1,26,2,5,8
2014-06-17T06:41:15.319,JEM,1,6,5,1,36,2,22,1,2,6
2014-06-17T06:39:04.784,IMM,2,6,3,3,23,1,9,1,4,6
2014-06-17T06:34:34.059,JCUBE,2,43,35,8,13,6,15,6,31,43
2014-06-17T06:32:37.519,IMM,1,6,6,0,25,2,47,3,2,6
2014-06-17T06:30:32.919,IMM,2,23,18,5,26,6,5,1,16,23
2014-06-17T06:24:57.946,WESTGATE,2,13,8,5,29,4,31,4,5,13
2014-06-17T06:23:27.547,JEM,0,7,0,7,38,3,40,3,2,7
2014-06-17T06:22:02.003,JEM,0,54,50,4,13,7,34,18,29,54
2014-06-17T06:21:51.775,JCUBE,1,117,81,36,39,45,38,44,27,117
2014-06-17T06:19:10.538,IMM,2,10,9,1,38,4,39,4,2,10
2014-06-17T06:14:25.811,IMM,2,9,6,3,13,1,50,4,3,9
2014-06-17T06:14:07.589,IMM,1,5,3,2,17,1,26,1,3,5
2014-06-17T06:12:03.311,JEM,0,6,5,1,17,1,17,1,4,6
2014-06-17T06:10:50.015,WESTGATE,2,5,4,1,7,0,44,2,3,5
2014-06-17T06:04:13.009,JEM,1,12,6,6,32,4,10,1,7,12
2014-06-17T06:02:54.423,IMM,1,5,3,2,16,1,7,0,4,5
2014-06-17T06:01:02.514,JEM,2,5,2,3,40,2,55,3,0,5
2014-06-17T05:52:29.261,JEM,0,5,0,5,33,2,42,2,1,5
2014-06-17T05:50:11.204,IMM,2,26,15,11,30,8,10,3,15,26
2014-06-17T05:48:27.865,IMM,0,5,3,2,10,1,35,2,3,5
2014-06-17T05:45:04.297,JEM,2,10,0,10,38,4,9,1,5,10
2014-06-17T05:43:41.304,IMM,0,5,1,4,3,0,0,0,5,5
2014-06-17T05:41:31.895,JCUBE,1,8,0,8,18,2,46,4,3,8
2014-06-17T05:41:01.52,IMM,2,9,8,1,25,2,17,2,5,9
2014-06-17T05:38:55.838,JCUBE,1,13,6,7,16,2,12,2,9,13
2014-06-17T05:31:15.68,IMM,0,9,3,6,1,0,22,2,7,9
2014-06-17T05:29:04.279,WESTGATE,2,17,13,4,17,3,51,9,6,17
2014-06-17T05:28:16.941,IMM,1,10,9,1,30,3,1,0,7,10
2014-06-17T05:26:37.685,IMM,2,11,4,7,39,4,24,3,4,11
2014-06-17T05:19:15.02,JEM,0,22,16,6,15,3,17,4,15,22
2014-06-17T05:16:09.956,JEM,1,5,3,2,8,0,42,2,3,5
2014-06-17T05:15:40.234,JEM,1,133,31,102,6,8,30,40,85,133
2014-06-17T05:14:03,WESTGATE,1,12,5,7,17,2,35,4,6,12
2014-06-17T05:08:28.74,WESTGATE,0,5,5,0,33,2,6,0,3,5
2014-06-17T05:07:00.276,IMM,0,8,0,8,13,1,46,4,3,8
2014-06-17T05:04:43.738,WESTGATE,2,5,3,2,18,1,44,2,2,5
2014-06-17T05:02:28.28,JEM,0,14,7,7,1,0,35,5,9,14
2014-06-17T04:59:58.423,JCUBE,2,6,1,5,23,1,46,3,2,6
2014-06-17T04:58:51.016,JEM,2,20,16,4,7,1,45,9,10,20
2014-06-17T04:57:44.323,JCUBE,0,5,0,5,34,2,13,1,3,5
2014-06-17T04:55:46.805,IMM,1,5,4,1,31,2,39,2,2,5
2014-06-17T04:53:57.452,WESTGATE,1,16,15,1,34,5,30,5,6,16
2014-06-17T04:52:09.189,JEM,0,10,0,10,1,0,54,6,5,10
2014-06-17T04:49:07.154,JCUBE,1,20,2,18,6,1,8,2,18,20
2014-06-17T04:47:45.627,JCUBE,1,22,18,4,20,4,20,4,13,22
2014-06-17T04:44:29.426,JCUBE,2,22,19,3,1,0,27,6,16,22
2014-06-17T04:43:46.568,WESTGATE,1,19,10,9,37,7,30,6,6,19
2014-06-17T04:42:35.027,WESTGATE,2,6,6,0,20,1,54,3,2,6
2014-06-17T04:38:18.077,IMM,1,7,3,4,5,0,43,3,3,7
2014-06-17T04:33:20.212,JCUBE,0,5,2,3,34,2,35,2,2,5
2014-06-17T04:29:43.293,JCUBE,1,15,1,14,15,2,19,3,10,15
2014-06-17T04:24:21.261,JCUBE,2,7,0,7,31,2,42,3,2,7
2014-06-17T04:20:46.48,JCUBE,1,5,3,2,19,1,27,1,3,5
2014-06-17T04:19:16.959,WESTGATE,0,25,21,4,11,3,56,14,8,25
2014-06-17T04:13:20.905,JEM,0,20,13,7,29,6,55,11,3,20
2014-06-17T04:11:01.735,WESTGATE,2,12,9,3,36,4,21,3,5,12
2014-06-17T04:09:59.879,WESTGATE,0,10,9,1,31,3,7,1,6,10
2014-06-17T04:09:00.933,IMM,2,5,5,0,2,0,8,0,5,5
2014-06-17T04:07:28.953,WESTGATE,2,5,1,4,23,1,16,1,3,5
2014-06-17T03:57:01.845,JEM,2,5,0,5,22,1,60,3,1,5
2014-06-17T03:55:15.417,JCUBE,0,10,1,9,5,0,35,3,6,10
2014-06-17T03:51:17.406,IMM,2,62,25,37,14,9,12,7,46,62
2014-06-17T03:50:47.32,IMM,1,5,1,4,32,2,42,2,1,5
2014-06-17T03:46:19.187,JEM,2,6,4,2,0,0,2,0,6,6
2014-06-17T03:42:50.367,JCUBE,1,5,0,5,35,2,53,3,1,5
2014-06-17T03:40:43.985,JEM,2,5,0,5,32,2,59,3,0,5
2014-06-17T03:39:25.621,JEM,1,5,3,2,15,1,19,1,3,5
2014-06-17T03:35:29.576,IMM,0,7,2,5,34,2,48,3,1,7
2014-06-17T03:32:43.831,JEM,0,5,4,1,12,1,60,3,1,5
2014-06-17T03:29:00.992,IMM,2,25,8,17,31,8,40,10,7,25
2014-06-17T03:22:18.079,WESTGATE,2,11,10,1,19,2,18,2,7,11
2014-06-17T03:20:59.179,WESTGATE,0,27,18,9,25,7,27,7,13,27
2014-06-17T03:18:57.497,JEM,1,11,10,1,11,1,45,5,5,11
2014-06-17T03:17:38.193,IMM,2,8,2,6,12,1,32,3,5,8
2014-06-17T03:15:26.558,IMM,0,13,9,4,22,3,55,7,3,13
2014-06-17T03:13:00.943,IMM,1,5,2,3,31,2,60,3,0,5
2014-06-17T03:10:57.779,JEM,1,5,3,2,39,2,20,1,2,5
2014-06-17T03:07:41.854,IMM,0,8,1,7,33,3,9,1,5,8
2014-06-17T03:03:48.593,WESTGATE,2,15,0,15,9,1,9,1,12,15
2014-06-17T03:00:23.506,IMM,1,7,5,2,8,1,51,4,3,7
2014-06-17T03:00:02.413,JCUBE,2,23,2,21,20,5,30,7,12,23
2014-06-17T02:56:41.667,IMM,2,19,4,15,25,5,49,10,5,19
2014-06-17T02:49:54.781,JCUBE,2,5,0,5,29,1,6,0,3,5
2014-06-17T02:46:45.753,JEM,0,19,12,7,8,2,9,2,16,19
2014-06-17T02:45:47.76,JCUBE,0,7,0,7,25,2,29,2,3,7
2014-06-17T02:41:21.26,WESTGATE,0,206,19,187,34,70,8,16,119,206
2014-06-17T02:39:15.104,JCUBE,2,5,1,4,12,1,41,2,2,5
2014-06-17T02:37:49.572,WESTGATE,2,36,19,17,10,4,18,6,26,36
2014-06-17T02:32:24.093,IMM,2,21,15,6,16,3,44,9,9,21
2014-06-17T02:28:51.633,JEM,1,5,1,4,19,1,49,3,2,5
2014-06-17T02:27:28.76,IMM,2,5,5,0,35,2,53,3,1,5
2014-06-17T02:23:45.587,IMM,1,6,0,6,21,1,1,0,4,6
2014-06-17T02:17:47.847,IMM,0,48,24,24,10,5,0,0,43,48
2014-06-17T02:15:04.931,WESTGATE,1,16,9,7,9,1,28,5,10,16
2014-06-17T02:13:53.586,JCUBE,1,5,0,5,34,2,21,1,2,5
2014-06-17T02:08:22.58,JEM,0,21,17,4,36,7,19,4,9,21
2014-06-17T02:04:05.665,JCUBE,2,5,4,1,9,0,43,2,3,5
2014-06-17T02:01:05.033,WESTGATE,2,12,6,6,10,1,53,6,4,12
2014-06-17T01:59:34.099,JCUBE,1,8,7,1,29,2,33,3,3,8
2014-06-17T01:58:01.843,WESTGATE,0,5,3,2,9,0,27,1,3,5
2014-06-17T01:55:09.203,JEM,2,20,6,14,17,3,28,6,11,20
2014-06-17T01:52:37.555,IMM,1,8,6,2,38,3,43,4,2,8
2014-06-17T01:47:02.143,WESTGATE,1,19,13,6,15,3,24,5,12,19
2014-06-17T01:40:33.105,IMM,1,18,17,1,33,6,42,8,5,18
2014-06-17T01:35:18.83,IMM,1,5,3,2,3,0,1,0,5,5
2014-06-17T01:31:23.328,WESTGATE,0,93,7,86,14,13,27,25,55,93
2014-06-17T01:24:36.197,JCUBE,1,22,9,13,15,3,8,2,17,22
2014-06-17T01:23:26.674,IMM,0,17,3,14,19,3,25,4,9,17
2014-06-17T01:20:54.745,JEM,2,8,7,1,39,3,13,1,4,8
2014-06-17T01:18:30.882,JCUBE,0,11,2,9,27,3,42,5,3,11
2014-06-17T01:16:34.573,JCUBE,2,36,1,35,26,9,24,9,18,36
2014-06-17T01:14:47.7,WESTGATE,1,5,2,3,36,2,32,2,2,5
2014-06-17T01:14:39.264,WESTGATE,2,10,2,8,20,2,56,6,2,10
2014-06-17T01:12:33.619,IMM,0,35,5,30,24,8,34,12,15,35
2014-06-17T01:10:23.961,WESTGATE,0,5,0,5,1,0,51,3,2,5
2014-06-17T01:06:28.084,IMM,2,6,2,4,26,2,16,1,3,6
2014-06-17T01:06:11.786,JCUBE,0,21,10,11,39,8,44,9,4,21
2014-06-17T01:00:02.81,WESTGATE,2,13,1,12,27,3,19,2,7,13
2014-06-17T00:54:59.964,WESTGATE,2,23,22,1,1,0,37,9,15,23
2014-06-17T00:49:27.38,JEM,0,5,2,3,19,1,19,1,3,5
2014-06-17T00:44:29.777,WESTGATE,0,21,17,4,16,3,52,11,7,21
2014-06-17T00:30:06.87,JEM,1,24,14,10,6,1,41,10,13,24
2014-06-17T00:25:12.822,IMM,1,12,4,8,25,3,40,5,4,12
2014-06-17T00:22:48.012,WESTGATE,2,8,3,5,10,1,7,1,7,8
2014-06-17T00:20:39.368,WESTGATE,2,7,2,5,11,1,2,0,6,7
2014-06-17T00:20:29.146,JEM,0,5,1,4,31,2,47,2,1,5
2014-06-17T00:07:18.243,IMM,0,8,2,6,20,2,42,3,3,8
2014-06-17T00:04:21.889,JEM,1,5,0,5,40,2,41,2,1,5
2014-06-17T00:02:55.37,IMM,0,37,32,5,38,14,28,10,12,37
2014-06-17T00:01:06.614,JCUBE,0,19,2,17,37,7,43,8,4,19
2014-06-16T23:56:02.468,IMM,0,7,0,7,27,2,10,1,5,7
2014-06-16T23:54:17.571,JEM,1,9,2,7,3,0,9,1,8,9
2014-06-16T23:46:42.851,JCUBE,2,10,4,6,24,2,48,5,3,10
2014-06-16T23:43:11.742,JCUBE,0,22,12,10,2,0,13,3,18,22
2014-06-16T23:39:01.049,JCUBE,2,5,5,0,25,1,28,1,2,5
2014-06-16T23:36:46.074,JEM,1,10,7,3,36,3,13,1,5,10
2014-06-16T23:33:34.245,IMM,2,5,2,3,18,1,52,3,2,5
2014-06-16T23:29:36.499,JEM,0,10,6,4,1,0,44,4,5,10
2014-06-16T23:15:31.198,JEM,0,5,3,2,38,2,43,2,1,5
2014-06-16T23:11:38.025,JEM,1,8,6,2,33,3,31,3,3,8
2014-06-16T22:55:34.1,JCUBE,0,13,10,3,33,4,45,6,3,13
2014-06-16T22:53:07.214,WESTGATE,2,22,18,4,37,8,47,10,4,22
2014-06-16T22:50:21.529,JCUBE,2,5,3,2,36,2,38,2,1,5
2014-06-16T22:49:15.543,JCUBE,0,9,4,5,3,0,11,1,8,9
2014-06-16T22:48:20.415,JEM,0,13,5,8,8,1,14,2,10,13
2014-06-16T22:42:17.885,JEM,1,13,12,1,22,3,12,2,9,13
2014-06-16T22:40:24.031,IMM,0,16,5,11,13,2,40,6,7,16
2014-06-16T22:35:27.668,JEM,2,14,5,9,14,2,28,4,8,14
2014-06-16T22:32:56.846,WESTGATE,0,7,1,6,13,1,5,0,6,7
2014-06-16T22:31:32.143,JEM,2,14,3,11,39,5,57,8,1,14
2014-06-16T22:29:49.609,JEM,1,8,8,0,24,2,39,3,3,8
2014-06-16T22:28:23.878,JCUBE,0,10,4,6,19,2,30,3,5,10
2014-06-16T22:23:57.969,JCUBE,0,10,2,8,39,4,3,0,6,10
2014-06-16T22:23:11.295,WESTGATE,0,20,9,11,36,7,3,1,12,20
2014-06-16T22:21:55.568,IMM,1,11,0,11,15,2,33,3,5,11
2014-06-16T22:15:57.117,WESTGATE,2,17,14,3,25,4,32,5,7,17
2014-06-16T22:11:35.768,JEM,0,5,0,5,23,1,36,2,2,5
2014-06-16T22:09:57.872,JEM,2,5,0,5,39,2,52,3,0,5
2014-06-16T22:08:22.678,WESTGATE,1,41,17,24,0,0,11,5,37,41
2014-06-16T22:01:42.86,IMM,2,174,60,114,16,28,54,94,52,174
2014-06-16T21:59:41.315,WESTGATE,2,12,1,11,22,3,17,2,8,12
2014-06-16T21:58:00.881,JEM,0,19,7,12,36,7,59,11,1,19
2014-06-16T21:53:48.731,JEM,2,9,2,7,5,0,1,0,9,9
2014-06-16T21:53:22.744,JEM,0,15,4,11,28,4,40,6,5,15
2014-06-16T21:51:33.341,JCUBE,2,11,7,4,21,2,37,4,5,11
2014-06-16T21:44:51.35,WESTGATE,1,5,2,3,0,0,29,2,4,5
2014-06-16T21:40:24.529,WESTGATE,1,5,0,5,21,1,56,3,1,5
2014-06-16T21:37:31.715,JEM,1,5,2,3,31,2,22,1,2,5
2014-06-16T21:36:36.801,JCUBE,1,5,0,5,14,1,24,1,3,5
2014-06-16T21:34:39.987,JEM,2,8,5,3,29,2,18,1,4,8
2014-06-16T21:30:29.947,WESTGATE,2,5,0,5,11,1,13,1,4,5
2014-06-16T21:29:14.669,JEM,1,22,17,5,7,2,22,5,16,22
2014-06-16T21:28:18.734,WESTGATE,2,17,5,12,23,4,24,4,9,17
2014-06-16T21:26:54.173,JCUBE,2,5,0,5,32,2,8,0,3,5
2014-06-16T21:22:09.351,WESTGATE,2,78,70,8,6,5,30,23,50,78
2014-06-16T21:20:39.004,WESTGATE,0,12,11,1,13,2,14,2,9,12
2014-06-16T21:19:00.958,IMM,2,5,1,4,15,1,18,1,3,5
2014-06-16T21:16:42.427,JEM,1,5,1,4,19,1,1,0,4,5
2014-06-16T21:14:39.374,WESTGATE,2,5,4,1,0,0,38,2,3,5
2014-06-16T21:08:02.766,JCUBE,0,30,26,4,28,8,42,13,9,30
2014-06-16T21:06:15.297,IMM,1,11,6,5,19,2,19,2,7,11
2014-06-16T21:04:38.35,JCUBE,0,20,10,10,35,7,45,9,4,20
2014-06-16T21:02:56.785,WESTGATE,0,19,11,8,8,1,59,11,6,19
2014-06-16T21:00:57.846,JEM,0,7,0,7,23,2,23,2,4,7
2014-06-16T20:57:57.231,JCUBE,2,9,0,9,25,2,15,1,6,9
2014-06-16T20:50:31.511,JEM,0,5,2,3,27,1,16,1,3,5
2014-06-16T20:49:06.954,JEM,0,5,2,3,25,1,57,3,1,5
2014-06-16T20:46:57.403,JCUBE,1,7,4,3,17,1,24,2,4,7
2014-06-16T20:43:11.515,JEM,0,5,4,1,20,1,58,3,1,5
2014-06-16T20:41:45.021,IMM,1,5,3,2,7,0,41,2,3,5
2014-06-16T20:40:00.507,JCUBE,2,6,6,0,18,1,8,1,5,6
2014-06-16T20:31:14.56,WESTGATE,0,16,14,2,38,6,40,6,3,16
2014-06-16T20:26:09.993,IMM,0,23,19,4,34,8,19,4,11,23
2014-06-16T20:20:18.566,IMM,2,13,11,2,30,4,35,4,4,13
2014-06-16T20:17:24.706,IMM,2,9,7,2,10,1,13,1,7,9
2014-06-16T20:16:23.77,JEM,1,5,4,1,14,1,36,2,3,5
2014-06-16T20:13:27.47,IMM,1,15,14,1,5,1,56,9,6,15
2014-06-16T20:12:07.839,JCUBE,1,6,6,0,4,0,17,1,5,6
2014-06-16T20:09:59.657,JEM,0,5,0,5,37,2,16,1,2,5
2014-06-16T20:07:54.851,WESTGATE,2,8,6,2,13,1,15,1,5,8
2014-06-16T20:06:08.349,WESTGATE,0,5,1,4,25,1,19,1,3,5
2014-06-16T20:04:40.165,IMM,1,14,1,13,18,3,38,6,6,14
2014-06-16T20:00:44.473,IMM,0,6,0,6,36,2,25,1,2,6
2014-06-16T19:53:25.894,IMM,0,5,3,2,21,1,49,2,2,5
2014-06-16T19:47:32.377,IMM,0,6,5,1,27,2,18,1,3,6
2014-06-16T19:44:48.63,IMM,1,6,0,6,34,2,12,1,3,6
2014-06-16T19:43:04.584,IMM,2,41,16,25,38,15,36,15,11,41
2014-06-16T19:40:44.72,IMM,0,5,4,1,9,0,52,3,2,5
2014-06-16T19:39:38.573,IMM,0,5,2,3,32,2,59,3,0,5
2014-06-16T19:34:39.61,JEM,1,5,1,4,24,1,21,1,3,5
2014-06-16T19:29:58.52,IMM,2,148,101,47,31,46,3,4,98,148
2014-06-16T19:22:17.192,IMM,1,5,5,0,23,1,13,1,3,5
2014-06-16T19:20:52.184,JCUBE,0,5,0,5,28,1,36,2,2,5
2014-06-16T19:18:21.246,WESTGATE,1,23,14,9,6,1,13,3,19,23
2014-06-16T19:17:00.053,JCUBE,1,6,5,1,21,1,13,1,4,6
2014-06-16T19:15:12.945,WESTGATE,0,5,1,4,4,0,39,2,3,5
2014-06-16T19:13:49.151,WESTGATE,0,5,1,4,14,1,38,2,2,5
2014-06-16T19:11:20.779,WESTGATE,1,5,4,1,14,1,41,2,2,5
2014-06-16T19:10:09.79,JEM,1,5,3,2,33,2,44,2,1,5
2014-06-16T19:07:41.282,JEM,2,15,10,5,11,2,26,4,9,15
2014-06-16T19:04:33.096,IMM,2,5,2,3,11,1,57,3,2,5
2014-06-16T18:53:34.749,JCUBE,1,20,2,18,21,4,13,3,13,20
2014-06-16T18:52:57.374,IMM,0,43,20,23,32,14,22,10,20,43
2014-06-16T18:47:53.875,JCUBE,2,17,0,17,11,2,24,4,11,17
2014-06-16T18:43:44.504,IMM,0,13,4,9,12,2,13,2,10,13
2014-06-16T18:42:19.806,JEM,1,16,12,4,26,4,3,0,12,16
2014-06-16T18:40:09.345,JEM,1,5,1,4,21,1,40,2,2,5
2014-06-16T18:38:23.098,JCUBE,1,58,31,27,36,21,17,10,27,58
2014-06-16T18:38:19.946,IMM,1,5,1,4,16,1,51,3,2,5
2014-06-16T18:35:45.814,WESTGATE,0,9,6,3,4,0,33,3,5,9
2014-06-16T18:33:21.669,JEM,2,8,5,3,2,0,20,2,6,8
2014-06-16T18:28:05.71,JEM,1,46,23,23,1,0,37,17,28,46
2014-06-16T18:26:29.418,IMM,1,8,6,2,15,1,54,4,2,8
2014-06-16T18:24:56.204,IMM,1,7,0,7,32,2,49,4,1,7
2014-06-16T18:20:40.224,JCUBE,0,10,1,9,28,3,20,2,5,10
2014-06-16T18:17:38.019,JCUBE,0,5,1,4,13,1,13,1,4,5
2014-06-16T18:13:35.528,WESTGATE,0,5,3,2,36,2,38,2,1,5
2014-06-16T18:09:29.66,WESTGATE,1,9,2,7,15,1,45,4,3,9
2014-06-16T18:02:06.425,JEM,2,5,5,0,6,0,14,1,4,5
2014-06-16T17:59:09.79,IMM,0,27,1,26,28,7,1,0,19,27
2014-06-16T17:58:46.601,JCUBE,2,14,7,7,22,3,36,5,6,14
2014-06-16T17:55:53.43,JCUBE,0,5,3,2,22,1,50,3,1,5
2014-06-16T17:54:53.634,WESTGATE,1,57,34,23,29,17,6,3,37,57
2014-06-16T17:52:31.46,WESTGATE,2,9,8,1,33,3,27,2,3,9
2014-06-16T17:43:20.933,WESTGATE,0,9,3,6,40,3,26,2,3,9
2014-06-16T17:41:42.301,JCUBE,1,24,10,14,15,4,29,7,13,24
2014-06-16T17:39:32.393,JCUBE,1,12,12,0,33,4,45,5,3,12
2014-06-16T17:37:08.682,IMM,2,11,6,5,9,1,4,0,10,11
2014-06-16T17:34:36.782,IMM,2,6,5,1,13,1,50,3,2,6
2014-06-16T17:32:45.989,JEM,2,22,13,9,17,4,3,1,18,22
2014-06-16T17:30:28.27,JCUBE,0,9,1,8,20,2,25,2,5,9
2014-06-16T17:29:54.95,JCUBE,2,9,0,9,25,2,57,5,2,9
2014-06-16T17:28:29.289,IMM,0,5,2,3,4,0,24,1,4,5
2014-06-16T17:25:37.289,JEM,0,313,274,39,18,56,20,63,194,313
2014-06-16T17:24:59.713,JEM,0,5,5,0,0,0,11,1,5,5
2014-06-16T17:24:07.962,IMM,0,444,218,226,15,67,21,93,284,444
2014-06-16T17:23:23.748,JEM,1,10,2,8,30,3,49,5,2,10
2014-06-16T17:21:41.239,JCUBE,0,16,10,6,28,4,1,0,11,16
2014-06-16T17:18:42.084,JCUBE,2,5,2,3,1,0,46,2,3,5
2014-06-16T17:18:09.799,JCUBE,0,10,2,8,8,1,48,5,4,10
2014-06-16T17:15:37.731,IMM,2,5,3,2,24,1,31,2,2,5
2014-06-16T17:13:22.209,JEM,2,5,4,1,16,1,21,1,3,5
2014-06-16T17:03:40.745,WESTGATE,1,5,5,0,2,0,42,2,3,5
2014-06-16T17:02:13.73,JEM,1,11,0,11,2,0,51,6,5,11
2014-06-16T16:58:25.636,JCUBE,0,22,14,8,27,6,9,2,14,22
2014-06-16T16:58:01.353,WESTGATE,0,32,19,13,29,9,13,4,18,32
2014-06-16T16:54:58.968,IMM,0,21,13,8,19,4,31,6,10,21
2014-06-16T16:48:24.777,WESTGATE,0,29,8,21,34,10,38,11,8,29
2014-06-16T16:41:59.489,JCUBE,0,18,3,15,24,4,3,1,13,18
2014-06-16T16:40:04.905,JEM,2,10,1,9,10,1,58,6,3,10
2014-06-16T16:38:03.42,JCUBE,1,5,2,3,22,1,31,2,2,5
2014-06-16T16:34:07.264,IMM,1,8,3,5,16,1,30,2,4,8
2014-06-16T16:31:53.232,WESTGATE,2,7,5,2,40,3,57,4,0,7
2014-06-16T16:27:38.249,IMM,2,13,2,11,4,1,58,7,5,13
2014-06-16T16:27:21.085,JCUBE,1,8,7,1,31,2,39,3,2,8
2014-06-16T16:25:33.532,WESTGATE,2,23,0,23,7,2,12,3,18,23
2014-06-16T16:23:24.229,JCUBE,2,5,4,1,8,0,43,2,3,5
2014-06-16T16:22:13.768,JCUBE,1,5,0,5,4,0,24,1,4,5
2014-06-16T16:19:25.116,WESTGATE,0,7,5,2,15,1,21,1,5,7
2014-06-16T16:17:31.245,JCUBE,2,5,4,1,2,0,47,2,3,5
2014-06-16T16:14:29.685,JEM,1,10,1,9,20,2,15,2,7,10
2014-06-16T16:11:55.932,JCUBE,2,8,5,3,5,0,16,1,6,8
2014-06-16T16:09:11.861,JEM,0,11,8,3,30,3,29,3,5,11
2014-06-16T16:05:16.846,JEM,1,16,6,10,6,1,6,1,14,16
2014-06-16T16:02:02.413,JCUBE,0,8,4,4,14,1,51,4,3,8
2014-06-16T16:00:01.509,JEM,0,5,3,2,28,1,55,3,1,5
2014-06-16T15:56:56.502,IMM,0,17,5,12,28,5,33,6,7,17
2014-06-16T15:54:36.265,WESTGATE,0,9,2,7,5,0,48,4,4,9
2014-06-16T15:51:05.949,JEM,0,5,0,5,40,2,0,0,3,5
2014-06-16T15:48:44.816,IMM,0,8,4,4,27,2,53,4,2,8
2014-06-16T15:46:13.74,JEM,1,12,6,6,38,5,21,3,5,12
2014-06-16T15:44:30.97,WESTGATE,1,5,2,3,13,1,18,1,3,5
2014-06-16T15:43:00.035,IMM,0,5,1,4,23,1,26,1,3,5
2014-06-16T15:39:07.212,JCUBE,0,15,14,1,18,3,9,1,11,15
2014-06-16T15:32:54.449,JCUBE,0,10,4,6,13,1,33,3,5,10
2014-06-16T15:31:10.556,IMM,2,26,4,22,10,3,24,6,17,26
2014-06-16T15:28:26.435,WESTGATE,2,5,0,5,20,1,33,2,2,5
2014-06-16T15:27:26.365,IMM,2,5,1,4,35,2,11,1,3,5
2014-06-16T15:24:43.656,WESTGATE,0,24,17,7,13,3,36,9,12,24
2014-06-16T15:21:55.266,IMM,2,7,3,4,26,2,13,1,4,7
2014-06-16T15:18:39.185,JEM,2,5,2,3,6,0,39,2,3,5
2014-06-16T15:18:04.768,JCUBE,0,14,14,0,34,5,44,6,3,14
2014-06-16T15:16:17.755,IMM,2,5,0,5,6,0,37,2,3,5
2014-06-16T15:13:27.112,JEM,0,5,3,2,26,1,27,1,2,5
2014-06-16T15:12:19.468,JCUBE,1,26,18,8,24,6,9,2,17,26
2014-06-16T15:08:09.462,JEM,2,19,7,12,30,6,58,11,2,19
2014-06-16T15:06:36.791,JCUBE,1,9,2,7,10,1,20,2,6,9
2014-06-16T15:03:26.282,JEM,1,5,5,0,9,0,10,1,4,5
2014-06-16T15:00:41.808,JEM,0,5,0,5,26,1,7,0,3,5
2014-06-16T14:59:15.728,JCUBE,1,21,14,7,25,5,51,11,5,21
2014-06-16T14:56:46.123,WESTGATE,0,12,3,9,5,1,3,0,11,12
2014-06-16T14:54:52.442,JEM,2,7,1,6,38,3,43,3,1,7
2014-06-16T14:52:42.164,IMM,1,5,2,3,36,2,45,2,1,5
2014-06-16T14:50:01.895,JEM,2,5,2,3,36,2,5,0,3,5
2014-06-16T14:47:02.523,WESTGATE,1,20,3,17,39,8,7,1,11,20
2014-06-16T14:45:08.519,JCUBE,2,5,4,1,17,1,26,1,3,5
2014-06-16T14:42:39.52,JEM,0,18,0,18,13,2,22,4,12,18
2014-06-16T14:40:51.796,JEM,0,52,51,1,12,6,13,7,39,52
2014-06-16T14:40:17.752,WESTGATE,1,20,2,18,24,5,31,6,9,20
2014-06-16T14:37:53.13,WESTGATE,1,11,10,1,9,1,36,4,6,11
2014-06-16T14:31:19.083,WESTGATE,1,5,1,4,10,1,5,0,4,5
2014-06-16T14:29:51.685,IMM,0,11,9,2,36,4,38,4,3,11
2014-06-16T14:29:23.489,WESTGATE,2,5,1,4,9,0,60,3,2,5
2014-06-16T14:25:03.23,JEM,0,5,4,1,17,1,39,2,2,5
2014-06-16T14:23:55.902,JEM,0,14,4,10,20,3,52,7,4,14
2014-06-16T14:23:29.727,JEM,0,7,0,7,18,1,11,1,5,7
2014-06-16T14:21:09.647,IMM,1,5,1,4,15,1,36,2,3,5
2014-06-16T14:19:06.915,JEM,0,41,20,21,33,14,25,10,17,41
2014-06-16T14:17:42.905,JCUBE,0,10,10,0,35,4,35,4,3,10
2014-06-16T14:16:16.871,WESTGATE,0,84,49,35,39,33,57,48,3,84
2014-06-16T14:15:39.877,JCUBE,2,21,14,7,24,5,0,0,16,21
2014-06-16T14:14:38.343,JCUBE,1,35,33,2,8,3,51,18,14,35
2014-06-16T14:13:21.116,JCUBE,0,5,5,0,29,1,50,3,1,5
2014-06-16T14:09:00.824,JCUBE,2,5,1,4,11,1,11,1,4,5
2014-06-16T14:07:45.274,WESTGATE,1,9,8,1,10,1,22,2,6,9
2014-06-16T14:03:59.831,IMM,2,21,9,12,11,2,57,12,7,21
2014-06-16T14:03:59.204,WESTGATE,1,5,2,3,12,1,14,1,4,5
2014-06-16T13:58:37.464,WESTGATE,2,11,10,1,36,4,45,5,2,11
2014-06-16T13:56:46.113,WESTGATE,1,14,11,3,35,5,59,8,1,14
2014-06-16T13:52:27.91,JEM,2,11,7,4,26,3,31,3,5,11
2014-06-16T13:50:18.096,IMM,2,13,3,10,34,4,44,6,3,13
2014-06-16T13:45:03.544,IMM,1,5,3,2,23,1,20,1,3,5
2014-06-16T13:43:42.82,JCUBE,2,5,2,3,29,2,21,1,3,5
2014-06-16T13:39:16.179,JCUBE,0,18,9,9,39,7,22,4,7,18
2014-06-16T13:35:54.558,JEM,2,21,11,10,29,6,31,7,9,21
2014-06-16T13:34:31.399,IMM,2,10,1,9,29,3,20,2,5,10
2014-06-16T13:33:03.55,JCUBE,1,5,5,0,27,1,2,0,4,5
2014-06-16T13:31:22.28,WESTGATE,1,20,12,8,27,5,37,7,7,20
2014-06-16T13:30:15.488,IMM,1,9,4,5,40,4,50,4,1,9
2014-06-16T13:29:15.643,IMM,1,16,7,9,6,1,38,6,9,16
2014-06-16T13:24:53.412,IMM,2,13,12,1,32,4,55,7,2,13
2014-06-16T13:21:47.656,JEM,0,29,22,7,10,3,1,0,26,29
2014-06-16T13:20:12.936,IMM,2,5,1,4,11,1,7,0,4,5
2014-06-16T13:17:38.585,JCUBE,2,6,5,1,13,1,12,1,5,6
2014-06-16T13:15:09.475,WESTGATE,0,5,5,0,31,2,22,1,2,5
2014-06-16T13:13:25.289,JEM,1,11,7,4,15,2,7,1,8,11
2014-06-16T13:12:18.207,JEM,0,9,8,1,31,3,37,3,3,9
2014-06-16T13:10:38.854,JEM,0,8,2,6,14,1,12,1,6,8
2014-06-16T13:07:56.694,JCUBE,1,6,2,4,36,2,23,1,2,6
2014-06-16T13:05:48.589,IMM,1,15,8,7,34,5,30,4,5,15
2014-06-16T13:03:03.802,JCUBE,2,9,0,9,15,1,55,5,3,9
2014-06-16T13:02:48.037,IMM,1,12,3,9,25,3,59,7,2,12
2014-06-16T13:00:34.873,JCUBE,0,10,5,5,36,4,3,0,6,10
2014-06-16T12:55:18.626,WESTGATE,1,5,5,0,4,0,58,3,2,5
2014-06-16T12:52:39.08,IMM,1,5,3,2,4,0,44,2,3,5
2014-06-16T12:50:47.088,WESTGATE,0,13,5,8,40,5,26,3,4,13
2014-06-16T12:48:23.593,WESTGATE,2,16,15,1,20,3,6,1,12,16
2014-06-16T12:45:35.552,IMM,2,5,0,5,1,0,58,3,2,5
2014-06-16T12:43:55.13,WESTGATE,0,5,4,1,36,2,30,2,2,5
2014-06-16T12:41:04.494,WESTGATE,2,5,5,0,0,0,19,1,4,5
2014-06-16T12:38:01.397,IMM,2,13,4,9,28,4,5,1,8,13
2014-06-16T12:36:18.91,JEM,0,5,1,4,36,2,58,3,0,5
2014-06-16T12:35:11.207,WESTGATE,1,11,10,1,21,2,49,5,3,11
2014-06-16T12:31:50.078,JCUBE,0,10,0,10,5,1,53,5,4,10
2014-06-16T12:29:56.804,JCUBE,0,8,3,5,18,1,27,2,4,8
2014-06-16T12:27:19.73,JCUBE,1,5,4,1,0,0,48,2,3,5
2014-06-16T12:26:18.127,JEM,2,9,1,8,0,0,13,1,8,9
2014-06-16T12:24:24.423,JEM,0,19,9,10,10,2,13,2,15,19
2014-06-16T12:20:58.705,JCUBE,0,5,0,5,35,2,44,2,1,5
2014-06-16T12:18:32.981,IMM,1,8,1,7,0,0,26,2,6,8
2014-06-16T12:16:18.761,JEM,1,10,5,5,3,0,15,1,8,10
2014-06-16T12:13:10.533,JCUBE,0,7,1,6,17,1,30,2,4,7
2014-06-16T12:11:47.798,JEM,0,10,9,1,32,3,19,2,5,10
2014-06-16T12:09:56.485,JEM,2,5,1,4,8,0,49,2,2,5
2014-06-16T12:07:43.669,WESTGATE,1,5,1,4,4,0,39,2,3,5
2014-06-16T12:05:49.623,IMM,2,8,6,2,4,0,46,4,4,8
2014-06-16T12:03:09.207,JEM,1,5,1,4,20,1,4,0,4,5
2014-06-16T12:01:39.795,WESTGATE,1,126,50,76,16,20,37,47,59,126
2014-06-16T11:59:29.394,WESTGATE,1,6,0,6,3,0,0,0,6,6
2014-06-16T11:59:09.924,JEM,2,5,4,1,36,2,27,1,2,5
2014-06-16T11:57:18.631,IMM,1,20,19,1,38,8,45,9,3,20
2014-06-16T11:55:21.559,WESTGATE,0,6,5,1,14,1,54,3,2,6
2014-06-16T11:53:55.538,WESTGATE,1,10,3,7,30,3,34,3,3,10
2014-06-16T11:51:28.599,JEM,2,11,4,7,10,1,23,3,8,11
2014-06-16T11:49:21.403,IMM,1,5,0,5,15,1,16,1,3,5
2014-06-16T11:47:49.706,JCUBE,1,11,7,4,1,0,46,5,6,11
2014-06-16T11:44:19.222,JEM,2,5,4,1,2,0,45,2,3,5
2014-06-16T11:40:34.952,JCUBE,1,17,13,4,18,3,34,6,8,17
2014-06-16T11:39:05.21,JEM,0,5,0,5,6,0,42,2,3,5
2014-06-16T11:36:52.899,JEM,1,7,1,6,0,0,32,2,5,7
2014-06-16T11:35:38.6,IMM,1,5,1,4,34,2,26,1,2,5
2014-06-16T11:34:05.132,JCUBE,2,7,2,5,10,1,13,1,5,7
2014-06-16T11:30:38.045,JEM,0,14,12,2,27,4,47,6,4,14
2014-06-16T11:28:31.135,WESTGATE,0,36,25,11,36,13,50,18,5,36
2014-06-16T11:24:48.807,IMM,2,5,1,4,38,2,2,0,3,5
2014-06-16T11:21:59.698,IMM,1,8,0,8,12,1,0,0,7,8
2014-06-16T11:18:11.343,JCUBE,1,15,5,10,33,5,0,0,10,15
2014-06-16T11:17:32.144,WESTGATE,0,10,3,7,25,3,44,5,3,10
2014-06-16T11:14:02.621,JEM,2,11,10,1,18,2,24,3,6,11
2014-06-16T11:11:59.851,JCUBE,1,31,26,5,30,9,60,19,3,31
2014-06-16T11:09:14.775,JEM,1,5,5,0,13,1,49,3,2,5
2014-06-16T11:07:34.88,IMM,0,14,4,10,28,4,4,1,10,14
2014-06-16T11:05:12.293,JCUBE,0,10,2,8,19,2,35,3,4,10
2014-06-16T11:04:39.553,JEM,1,12,1,11,24,3,16,2,7,12
2014-06-16T11:03:33.199,JCUBE,2,24,11,13,4,1,12,3,20,24
2014-06-16T11:01:57.441,JCUBE,0,26,8,18,1,0,23,6,20,26
2014-06-16T11:00:02.758,JEM,2,8,5,3,35,3,38,3,2,8
2014-06-16T10:58:12.373,IMM,0,10,2,8,5,0,29,3,6,10
2014-06-16T10:56:37.284,JEM,2,16,15,1,1,0,30,5,11,16
2014-06-16T10:52:55.3,JEM,0,9,2,7,37,3,50,5,1,9
2014-06-16T10:51:06.751,JEM,2,26,5,21,35,9,7,2,15,26
2014-06-16T10:50:10.981,JEM,0,5,3,2,8,0,55,3,2,5
2014-06-16T10:49:40.105,IMM,0,14,7,7,27,4,35,5,5,14
2014-06-16T10:48:35.643,JEM,2,68,11,57,21,14,46,31,22,68
2014-06-16T10:47:49.386,IMM,2,39,10,29,33,13,31,12,14,39
2014-06-16T10:43:41.74,JEM,2,16,1,15,12,2,47,7,7,16
2014-06-16T10:42:09.1,WESTGATE,0,11,11,0,17,2,46,5,4,11
2014-06-16T10:40:04.553,JCUBE,2,7,4,3,19,1,34,3,4,7
2014-06-16T10:38:22.311,JEM,1,5,3,2,28,1,15,1,3,5
2014-06-16T10:36:17.467,IMM,2,12,2,10,4,0,60,7,4,12
2014-06-16T10:35:40.35,IMM,2,5,2,3,34,2,49,3,1,5
2014-06-16T10:33:35.806,IMM,1,5,2,3,20,1,6,0,4,5
2014-06-16T10:25:41.088,WESTGATE,2,7,7,0,9,1,50,4,3,7
2014-06-16T10:23:52.274,JEM,1,27,10,17,8,2,27,7,17,27
2014-06-16T10:22:38.772,IMM,1,10,9,1,9,1,50,5,4,10
2014-06-16T10:22:11.432,JEM,1,20,4,16,5,1,40,8,11,20
2014-06-16T10:17:13.666,IMM,0,5,4,1,17,1,47,2,2,5
2014-06-16T10:15:37.856,IMM,2,11,0,11,19,2,13,1,7,11
2014-06-16T10:14:30.402,JCUBE,1,10,6,4,10,1,56,6,3,10
2014-06-16T10:13:15.157,JEM,2,27,13,14,15,4,12,3,20,27
2014-06-16T10:11:44.332,JEM,2,5,5,0,15,1,7,0,4,5
2014-06-16T10:08:05.393,JCUBE,2,16,0,16,18,3,47,7,5,16
2014-06-16T10:05:33.868,JEM,1,12,0,12,18,2,41,5,5,12
2014-06-16T09:59:46.177,WESTGATE,1,5,3,2,32,2,38,2,2,5
2014-06-16T09:57:33.571,IMM,1,5,1,4,29,1,27,1,2,5
2014-06-16T09:56:18.632,IMM,0,6,1,5,18,1,56,4,2,6
2014-06-16T09:54:48.948,IMM,0,6,0,6,35,2,23,1,3,6
2014-06-16T09:47:50.689,JCUBE,1,5,0,5,21,1,26,1,3,5
2014-06-16T09:42:36.88,JEM,1,18,17,1,37,7,44,8,3,18
2014-06-16T09:41:15.204,JCUBE,0,9,5,4,38,4,26,2,3,9
2014-06-16T09:39:34.692,JEM,1,90,64,26,13,12,7,6,72,90
2014-06-16T09:36:22.675,JEM,2,16,2,14,32,5,58,10,2,16
2014-06-16T09:32:52.413,JCUBE,1,18,17,1,38,7,16,3,8,18
2014-06-16T09:30:52.515,JEM,1,23,6,17,15,3,39,9,11,23
2014-06-16T09:29:35.055,WESTGATE,1,5,3,2,38,2,53,3,0,5
2014-06-16T09:26:54.23,WESTGATE,2,5,2,3,1,0,53,3,2,5
2014-06-16T09:24:04.338,WESTGATE,1,5,5,0,32,2,22,1,2,5
2014-06-16T09:21:29.132,JEM,1,5,4,1,28,1,6,0,3,5
2014-06-16T09:20:26.781,JCUBE,2,14,0,14,14,2,12,2,10,14
2014-06-16T09:18:34.717,JCUBE,1,5,5,0,12,1,25,1,3,5
2014-06-16T09:17:33.414,JEM,0,5,3,2,10,1,46,2,2,5
2014-06-16T09:16:11.734,JCUBE,2,5,0,5,30,2,56,3,1,5
2014-06-16T09:15:32.682,JEM,2,5,0,5,10,1,36,2,3,5
2014-06-16T09:13:26.446,JCUBE,2,29,29,0,35,10,20,6,13,29
2014-06-16T09:11:21.43,IMM,2,13,11,2,1,0,2,0,12,13
2014-06-16T09:11:13.173,JCUBE,2,21,13,8,39,8,26,5,7,21
2014-06-16T09:09:09.135,JEM,1,5,0,5,6,0,2,0,5,5
2014-06-16T09:08:06.339,WESTGATE,2,5,4,1,39,2,44,2,1,5
2014-06-16T09:05:42.795,JEM,1,324,154,170,1,3,44,142,178,324
2014-06-16T09:04:22.154,WESTGATE,2,11,3,8,8,1,26,3,7,11
2014-06-16T09:04:06.871,JCUBE,1,21,1,20,34,7,31,6,7,21
2014-06-16T09:01:04.339,JCUBE,1,7,5,2,22,1,10,1,5,7
2014-06-16T08:59:17.289,WESTGATE,2,22,19,3,6,1,49,11,10,22
2014-06-16T08:56:06.012,JEM,1,5,4,1,6,0,45,2,3,5
2014-06-16T08:52:29.633,JCUBE,2,13,9,4,0,0,29,4,9,13
2014-06-16T08:51:25.472,WESTGATE,0,5,0,5,0,0,51,3,3,5
2014-06-16T08:49:43.258,JEM,2,5,4,1,38,2,30,2,2,5
2014-06-16T08:47:21.704,JCUBE,2,17,4,13,24,4,37,6,6,17
2014-06-16T08:44:09.742,IMM,2,10,8,2,35,3,44,4,2,10
2014-06-16T08:38:54.758,IMM,1,22,1,21,21,5,43,9,8,22
2014-06-16T08:35:35.316,WESTGATE,0,5,1,4,10,1,41,2,2,5
2014-06-16T08:29:05.828,JEM,1,17,10,7,37,6,45,7,3,17
2014-06-16T08:25:25.921,JCUBE,2,23,8,15,30,7,60,14,2,23
2014-06-16T08:24:14.587,JEM,2,30,18,12,31,9,26,8,13,30
2014-06-16T08:23:38.489,JEM,0,0,0,0,18,0,45,0,0,0
2014-06-16T08:21:23.977,WESTGATE,0,19,11,8,20,4,41,8,8,19
2014-06-16T08:17:32.951,IMM,2,8,3,5,16,1,52,4,3,8
2014-06-16T08:15:38.57,IMM,0,15,11,4,37,6,25,4,6,15
2014-06-16T08:13:54.272,JCUBE,0,5,3,2,22,1,26,1,3,5
2014-06-16T08:12:26.779,WESTGATE,2,11,10,1,25,3,3,0,8,11
2014-06-16T08:11:02.741,WESTGATE,2,5,5,0,23,1,43,2,2,5
2014-06-16T08:08:36.259,IMM,1,27,4,23,33,9,2,1,17,27
2014-06-16T08:05:34.464,IMM,2,5,0,5,40,2,8,0,3,5
2014-06-16T08:01:31.801,JCUBE,1,5,5,0,36,2,11,1,3,5
2014-06-16T07:59:36.641,IMM,1,17,11,6,13,2,23,4,11,17
2014-06-16T07:57:41.075,WESTGATE,0,64,61,3,40,26,51,33,6,64
2014-06-16T07:55:34.07,JCUBE,0,27,27,0,26,7,37,10,10,27
2014-06-16T07:53:27.023,JCUBE,2,5,2,3,12,1,23,1,3,5
2014-06-16T07:51:31.308,WESTGATE,2,15,6,9,27,4,49,7,4,15
2014-06-16T07:48:17.151,IMM,1,9,7,2,6,1,8,1,8,9
2014-06-16T07:46:05.47,WESTGATE,2,16,0,16,29,5,46,7,4,16
2014-06-16T07:43:27.749,JEM,2,16,15,1,14,2,54,8,5,16
2014-06-16T07:42:10.053,WESTGATE,1,62,56,6,26,16,55,34,12,62
2014-06-16T07:39:20.11,WESTGATE,1,19,0,19,34,6,32,6,6,19
2014-06-16T07:37:57.214,JEM,1,25,4,21,25,6,30,7,11,25
2014-06-16T07:37:14.368,JEM,0,5,4,1,6,0,26,1,3,5
2014-06-16T07:35:53.105,IMM,0,5,2,3,24,1,10,1,3,5
2014-06-16T07:34:13,JCUBE,1,10,6,4,33,3,10,1,5,10
2014-06-16T07:31:32.276,JEM,0,45,25,20,34,15,46,21,9,45
2014-06-16T07:30:15.932,WESTGATE,2,13,2,11,40,5,33,4,4,13
2014-06-16T07:28:59.952,JEM,2,6,2,4,33,2,4,0,4,6
2014-06-16T07:26:49.024,JEM,1,21,15,6,11,2,5,1,18,21
2014-06-16T07:23:15.211,JCUBE,2,27,15,12,1,0,0,0,26,27
2014-06-16T07:21:50.033,WESTGATE,1,5,2,3,28,1,3,0,4,5
2014-06-16T07:20:02.064,IMM,0,10,7,3,11,1,19,2,7,10
2014-06-16T07:18:39.983,JEM,0,9,8,1,1,0,2,0,8,9
2014-06-16T07:18:20.718,IMM,2,9,1,8,38,4,48,4,1,9
2014-06-16T07:13:54.743,JEM,2,7,4,3,29,2,48,4,2,7
2014-06-16T07:12:35.363,IMM,1,20,1,19,36,7,40,8,5,20
2014-06-16T07:10:10.889,WESTGATE,0,22,7,15,15,3,3,1,18,22
2014-06-16T07:06:53.126,WESTGATE,1,18,12,6,16,3,0,0,15,18
2014-06-16T07:02:49.182,JCUBE,0,14,0,14,16,2,27,4,8,14
2014-06-16T07:00:20.283,IMM,1,24,17,7,33,8,13,3,13,24
2014-06-16T06:55:58.94,JCUBE,2,20,18,2,40,8,53,10,1,20
2014-06-16T06:53:34.266,IMM,0,18,1,17,16,3,12,2,13,18
2014-06-16T06:50:35.193,IMM,1,5,2,3,27,1,11,1,3,5
2014-06-16T06:48:53.291,IMM,2,15,13,2,26,4,49,8,4,15
2014-06-16T06:47:43.477,JCUBE,0,5,1,4,25,1,31,2,2,5
2014-06-16T06:42:40.757,JEM,1,20,2,18,21,4,4,1,15,20
2014-06-16T06:40:54.896,WESTGATE,1,24,22,2,13,3,49,12,9,24
2014-06-16T06:38:28.161,IMM,1,6,6,0,37,2,0,0,4,6
2014-06-16T06:36:39.967,WESTGATE,2,5,5,0,25,1,56,3,1,5
2014-06-16T06:33:48.436,WESTGATE,1,22,18,4,19,4,2,0,17,22
2014-06-16T06:30:36.227,JEM,2,49,36,13,13,6,17,8,34,49
2014-06-16T06:28:31.376,JEM,1,5,3,2,3,0,36,2,3,5
2014-06-16T06:27:09.623,JEM,2,13,13,0,21,3,22,3,8,13
2014-06-16T06:24:17.714,JEM,0,12,8,4,0,0,5,1,12,12
2014-06-16T06:23:23.724,JEM,1,315,28,287,7,22,20,63,230,315
2014-06-16T06:23:11.937,JCUBE,1,10,10,0,32,3,0,0,7,10
2014-06-16T06:22:03.189,JEM,0,16,9,7,32,5,56,9,2,16
2014-06-16T06:21:20.594,WESTGATE,0,12,5,7,5,1,16,2,9,12
2014-06-16T06:20:00.917,JEM,0,13,6,7,33,4,11,1,7,13
2014-06-16T06:16:35.794,JCUBE,0,12,6,6,31,4,26,3,5,12
2014-06-16T06:13:33.863,JEM,2,5,5,0,0,0,47,2,3,5
2014-06-16T06:09:16.72,WESTGATE,1,5,3,2,22,1,2,0,4,5
2014-06-16T06:08:22.069,IMM,0,16,13,3,32,5,13,2,9,16
2014-06-16T06:06:40.4,JEM,0,6,3,3,4,0,38,2,4,6
2014-06-16T06:04:59.986,WESTGATE,0,5,0,5,11,1,11,1,4,5
2014-06-16T06:03:17.198,JEM,1,10,8,2,32,3,51,5,2,10
2014-06-16T05:57:52.448,JEM,0,5,5,0,33,2,51,3,1,5
2014-06-16T05:56:49.317,IMM,1,32,23,9,32,10,56,18,4,32
2014-06-16T05:56:10.606,JEM,1,10,9,1,1,0,22,2,8,10
2014-06-16T05:53:51.72,WESTGATE,2,5,0,5,39,2,50,3,1,5
2014-06-16T05:51:48.376,JCUBE,2,10,1,9,33,3,58,6,1,10
2014-06-16T05:50:15.466,IMM,1,5,3,2,34,2,59,3,0,5
2014-06-16T05:46:46.589,IMM,0,7,6,1,40,3,32,2,2,7
2014-06-16T05:44:39.995,JCUBE,2,5,5,0,32,2,30,2,2,5
2014-06-16T05:42:32.049,WESTGATE,0,37,35,2,26,10,13,5,23,37
2014-06-16T05:41:17.553,JEM,2,5,0,5,38,2,6,0,3,5
2014-06-16T05:38:05.237,IMM,1,28,1,27,11,3,50,14,11,28
2014-06-16T05:37:02.581,JEM,0,10,7,3,10,1,2,0,9,10
2014-06-16T05:34:05.816,JCUBE,2,12,12,0,8,1,22,3,9,12
2014-06-16T05:31:16.483,WESTGATE,1,14,11,3,22,3,2,0,11,14
2014-06-16T05:27:37.216,JCUBE,1,15,7,8,23,3,34,5,6,15
2014-06-16T05:26:39.651,IMM,2,21,21,0,0,0,24,5,16,21
2014-06-16T05:24:17.409,IMM,0,5,5,0,26,1,0,0,4,5
2014-06-16T05:23:37.781,WESTGATE,1,15,13,2,23,4,23,4,8,15
2014-06-16T05:22:58.912,JCUBE,0,11,1,10,31,3,21,2,5,11
2014-06-16T05:19:25.034,IMM,2,31,11,20,39,12,6,2,17,31
2014-06-16T05:15:58.479,JCUBE,0,9,0,9,35,3,54,5,1,9
2014-06-16T05:15:28.43,JCUBE,2,6,3,3,4,0,9,1,5,6
2014-06-16T05:14:51.4,JCUBE,2,22,16,6,13,3,55,12,7,22
2014-06-16T05:12:57.835,WESTGATE,1,12,7,5,3,0,4,0,12,12
2014-06-16T05:08:57.931,IMM,2,12,5,7,27,3,34,4,5,12
2014-06-16T05:06:41.877,JCUBE,2,12,2,10,34,4,25,3,5,12
2014-06-16T05:05:17.486,IMM,1,34,1,33,0,0,57,19,14,34
2014-06-16T05:03:02.82,WESTGATE,1,5,1,4,10,1,2,0,5,5
2014-06-16T05:02:26.463,JEM,2,5,1,4,21,1,13,1,3,5
2014-06-16T04:58:08.562,JEM,0,8,5,3,11,1,51,4,3,8
2014-06-16T04:56:00.429,JCUBE,0,8,2,6,31,3,34,3,3,8
2014-06-16T04:52:18.111,JEM,1,42,15,27,37,15,0,0,26,42
2014-06-16T04:52:02.404,JCUBE,1,19,19,0,33,6,12,2,11,19
2014-06-16T04:50:33.202,JEM,0,6,2,4,0,0,52,3,3,6
2014-06-16T04:49:03.29,JCUBE,2,11,8,3,19,2,22,2,7,11
2014-06-16T04:46:56.647,WESTGATE,2,5,2,3,17,1,54,3,1,5
2014-06-16T04:42:22.812,WESTGATE,1,6,1,5,21,1,14,1,4,6
2014-06-16T04:40:31.154,JEM,1,25,13,12,3,1,17,4,20,25
2014-06-16T04:37:17.123,WESTGATE,1,10,10,0,31,3,25,3,5,10
2014-06-16T04:32:54.521,JEM,2,7,6,1,34,2,19,1,3,7
2014-06-16T04:31:01.599,JEM,1,34,17,17,10,3,1,0,31,34
2014-06-16T04:30:02.382,WESTGATE,1,5,4,1,38,2,42,2,1,5
2014-06-16T04:27:38.155,JEM,2,5,3,2,6,0,34,2,3,5
2014-06-16T04:25:00.613,JEM,1,144,140,4,33,47,34,49,47,144
2014-06-16T04:24:46.426,JEM,0,5,1,4,8,0,54,3,2,5
2014-06-16T04:24:10.864,JEM,1,12,8,4,21,3,14,2,8,12
2014-06-16T04:22:01.289,WESTGATE,0,9,8,1,29,3,37,3,3,9
2014-06-16T04:19:37.506,WESTGATE,0,12,7,5,15,2,57,7,3,12
2014-06-16T04:19:06.639,WESTGATE,0,218,128,90,32,70,49,107,41,218
2014-06-16T04:16:30.351,JEM,0,11,0,11,16,2,29,3,6,11
2014-06-16T04:12:50.119,WESTGATE,0,46,32,14,7,3,36,16,26,46
2014-06-16T04:12:00.568,JEM,2,6,3,3,30,2,31,2,2,6
2014-06-16T04:11:30.598,IMM,2,13,11,2,13,2,28,4,8,13
2014-06-16T04:08:04.234,IMM,0,5,4,1,33,2,38,2,1,5
2014-06-16T04:06:58.683,JCUBE,2,10,10,0,11,1,5,1,8,10
2014-06-16T04:04:11.02,JEM,1,18,5,13,11,2,19,3,13,18
2014-06-16T04:03:54.775,IMM,1,5,2,3,36,2,0,0,3,5
2014-06-16T04:02:32.397,JEM,2,17,3,14,9,2,56,9,6,17
2014-06-16T04:00:40.495,WESTGATE,1,13,8,5,20,3,27,3,7,13
2014-06-16T03:59:25.493,WESTGATE,0,27,9,18,9,2,41,11,13,27
2014-06-16T03:58:05.033,JCUBE,2,5,2,3,7,0,18,1,4,5
2014-06-16T03:56:03.07,WESTGATE,0,12,10,2,31,4,48,6,2,12
2014-06-16T03:51:35.749,IMM,0,19,9,10,34,7,52,10,3,19
2014-06-16T03:49:34.089,JEM,0,5,4,1,21,1,51,3,1,5
2014-06-16T03:47:43.885,JCUBE,1,12,5,7,39,5,28,3,4,12
2014-06-16T03:46:31.746,IMM,0,21,18,3,35,7,31,7,7,21
2014-06-16T03:42:46.847,IMM,2,6,3,3,33,2,25,1,2,6
2014-06-16T03:39:03.501,WESTGATE,2,6,4,2,36,2,26,1,2,6
2014-06-16T03:36:54.166,WESTGATE,1,5,5,0,30,2,0,0,4,5
2014-06-16T03:35:43.398,JEM,2,8,3,5,36,3,39,3,2,8
2014-06-16T03:34:11.19,WESTGATE,0,5,5,0,9,0,37,2,3,5
2014-06-16T03:30:45.282,JEM,1,16,13,3,25,4,4,1,12,16
2014-06-16T03:29:01.348,JCUBE,1,40,25,15,6,2,28,11,26,40
2014-06-16T03:26:50.889,JCUBE,2,17,7,10,26,4,57,9,3,17
2014-06-16T03:25:47.034,JCUBE,0,19,18,1,20,4,42,8,7,19
2014-06-16T03:21:31.345,WESTGATE,0,17,5,12,39,7,38,7,4,17
2014-06-16T03:15:06.191,WESTGATE,0,5,2,3,40,2,42,2,1,5
2014-06-16T03:12:55.589,IMM,2,34,33,1,17,6,22,7,20,34
2014-06-16T03:09:08.084,IMM,2,8,1,7,36,3,42,4,2,8
2014-06-16T03:06:58.889,WESTGATE,1,11,5,6,3,0,53,6,5,11
2014-06-16T03:06:13.62,IMM,0,5,0,5,12,1,36,2,3,5
2014-06-16T03:03:14.433,IMM,0,35,32,3,1,0,52,18,17,35
2014-06-16T02:56:27.347,IMM,2,9,6,3,25,2,29,2,4,9
2014-06-16T02:53:56.218,IMM,2,5,4,1,40,2,55,3,0,5
2014-06-16T02:51:51.342,JEM,2,5,1,4,37,2,49,2,1,5
2014-06-16T02:49:54.27,IMM,1,5,3,2,3,0,26,1,4,5
2014-06-16T02:45:27.142,JEM,1,6,0,6,14,1,41,2,3,6
2014-06-16T02:41:47.513,JEM,2,8,5,3,34,3,47,4,2,8
2014-06-16T02:37:27.876,JCUBE,2,9,1,8,8,1,0,0,8,9
2014-06-16T02:31:05.753,WESTGATE,0,8,3,5,18,1,6,0,6,8
2014-06-16T02:05:47.124,JCUBE,1,14,12,2,11,1,57,8,4,14
2014-06-16T01:39:03.945,JEM,0,25,24,1,27,7,47,12,6,25
2014-06-16T01:35:29.536,WESTGATE,1,24,19,5,16,4,30,7,13,24
2014-06-16T01:33:42.19,JCUBE,2,7,3,4,33,2,57,4,1,7
2014-06-16T01:31:27.612,WESTGATE,0,5,4,1,21,1,56,3,1,5
2014-06-16T01:18:40.991,IMM,1,9,0,9,18,2,15,1,6,9
2014-06-16T01:08:08.804,IMM,0,130,113,17,34,44,22,29,57,130
2014-06-16T00:55:55.422,WESTGATE,0,205,156,49,17,35,14,29,141,205
2014-06-16T00:40:23.965,IMM,0,26,17,9,29,8,19,5,14,26
2014-06-16T00:04:04.646,JEM,1,5,5,0,5,0,14,1,4,5
2014-06-15T22:29:58.483,IMM,2,5,2,3,12,1,40,2,2,5
2014-06-15T22:19:34.658,JEM,1,118,75,43,29,34,56,66,18,118
2014-06-15T21:55:24.828,JCUBE,1,5,5,0,14,1,59,3,1,5
2014-06-15T21:07:36.968,JEM,2,25,0,25,35,9,46,12,5,25
2014-06-15T19:37:24.825,JEM,2,18,17,1,4,1,42,8,10,18
2014-06-15T18:31:50.77,WESTGATE,0,10,8,2,17,2,17,2,7,10
2014-06-15T18:22:21.437,JEM,1,15,1,14,0,0,34,5,10,15
2014-06-15T17:57:53.017,JCUBE,1,9,1,8,4,0,6,1,8,9
2014-06-15T17:56:05.845,IMM,2,42,24,18,3,1,8,3,38,42
2014-06-15T17:38:47.711,WESTGATE,1,12,2,10,28,3,36,4,4,12
2014-06-15T17:28:39.948,JCUBE,1,279,35,244,32,89,42,117,72,279
2014-06-15T16:44:10.158,IMM,0,5,5,0,12,1,39,2,3,5
2014-06-15T16:10:27.537,JCUBE,0,156,68,88,40,62,33,51,42,156
2014-06-15T16:00:03.412,JEM,1,240,206,34,14,34,56,135,72,240
2014-06-15T15:45:02.086,WESTGATE,0,187,175,12,15,28,2,4,155,187
2014-06-15T15:25:42.316,JCUBE,0,13,11,2,12,2,54,7,4,13
2014-06-15T14:56:34.801,WESTGATE,0,78,31,47,19,15,36,28,35,78
2014-06-15T14:27:00.114,IMM,0,172,100,72,24,41,57,98,33,172
2014-06-15T14:10:24.814,JCUBE,0,101,22,79,7,7,19,19,75,101
2014-06-15T14:08:30.544,IMM,0,16,4,12,29,5,25,4,7,16
2014-06-15T13:56:28.782,WESTGATE,2,234,60,174,24,56,21,49,128,234
2014-06-15T13:26:19.386,IMM,2,12,7,5,31,4,29,3,5,12
2014-06-15T13:06:09.38,JCUBE,2,74,21,53,9,7,3,2,65,74
2014-06-15T12:57:05.177,IMM,2,27,22,5,37,10,12,3,14,27
2014-06-15T12:43:33.666,JEM,2,114,14,100,34,39,11,12,62,114
2014-06-15T12:03:30.211,IMM,2,5,0,5,9,0,23,1,3,5
2014-06-15T11:47:41.012,WESTGATE,0,5,5,0,19,1,1,0,4,5
2014-06-15T11:40:08.056,WESTGATE,1,5,1,4,17,1,50,3,2,5
2014-06-15T11:24:48.029,JCUBE,1,84,84,0,36,30,4,3,51,84
2014-06-15T10:47:45.645,JCUBE,1,145,17,128,6,9,26,38,99,145
2014-06-15T10:45:47.824,JCUBE,1,22,4,18,25,5,38,8,8,22
2014-06-15T10:15:09.106,WESTGATE,1,5,2,3,18,1,7,0,4,5
2014-06-15T10:11:20.526,JEM,1,24,20,4,33,8,57,13,2,24
2014-06-15T10:09:19.491,JCUBE,0,11,5,6,32,3,58,6,1,11
2014-06-15T09:50:46.788,JCUBE,1,13,6,7,29,4,34,4,5,13
2014-06-15T09:33:21.792,JEM,2,12,6,6,13,2,49,6,5,12
2014-06-15T09:13:44.349,WESTGATE,0,10,7,3,33,3,18,2,5,10
2014-06-15T08:58:59.889,JCUBE,2,13,1,12,35,5,31,4,5,13
2014-06-15T08:44:32.586,WESTGATE,2,5,4,1,29,1,18,1,3,5
2014-06-15T08:43:13.178,IMM,2,141,125,16,9,13,42,59,69,141
2014-06-15T08:34:45.129,IMM,0,5,1,4,32,2,26,1,2,5
2014-06-15T08:21:40.513,JEM,0,5,3,2,12,1,28,1,3,5
2014-06-15T08:18:58.854,JCUBE,0,7,1,6,3,0,9,1,6,7
2014-06-15T08:09:53.882,WESTGATE,0,56,7,49,19,11,18,10,35,56
2014-06-15T07:51:31.205,IMM,0,5,2,3,24,1,25,1,3,5
2014-06-15T07:37:13.116,WESTGATE,2,113,1,112,19,21,23,26,66,113
2014-06-15T07:29:11.571,JEM,2,10,3,7,16,2,17,2,7,10
2014-06-15T07:20:14.883,JEM,1,5,2,3,21,1,40,2,2,5
2014-06-15T07:17:23.65,WESTGATE,1,9,4,5,20,2,24,2,5,9
2014-06-15T07:07:46.472,JCUBE,1,5,3,2,3,0,38,2,3,5
2014-06-15T07:00:29.234,IMM,1,9,0,9,7,1,38,3,5,9
2014-06-15T06:22:18.293,JEM,2,41,26,15,7,3,22,9,29,41
2014-06-15T05:59:50.031,IMM,2,11,1,10,16,2,35,4,5,11
2014-06-15T05:43:11.453,IMM,0,112,81,31,38,43,29,33,37,112
2014-06-15T05:23:27.058,JEM,1,34,29,5,9,3,5,2,29,34
2014-06-15T05:19:29.036,WESTGATE,0,24,20,4,15,4,8,2,19,24
2014-06-15T03:34:18.782,JCUBE,1,93,61,32,5,5,11,10,78,93
2014-06-15T03:32:34.671,WESTGATE,1,5,1,4,15,1,60,3,1,5
2014-06-15T02:55:35.42,WESTGATE,0,21,18,3,5,1,26,5,14,21
2014-06-15T02:45:37.474,JCUBE,1,5,2,3,31,2,14,1,3,5
2014-06-15T02:41:52.496,JEM,2,12,8,4,3,0,36,4,8,12
2014-06-15T02:20:09.182,IMM,1,10,5,5,21,2,36,4,4,10
2014-06-15T01:41:49.716,JEM,1,10,5,5,5,0,19,2,8,10
2014-06-15T01:36:03.65,JEM,2,5,3,2,37,2,43,2,1,5
2014-06-15T00:48:51.033,JCUBE,2,224,179,45,6,13,59,132,79,224
2014-06-15T00:05:04.319,JCUBE,1,53,9,44,36,19,17,9,25,53
2014-06-14T23:16:56.24,JCUBE,2,11,1,10,7,1,15,2,9,11
2014-06-14T23:15:53.035,JEM,2,5,4,1,23,1,8,0,4,5
2014-06-14T23:14:33.724,JCUBE,1,146,29,117,15,22,53,77,47,146
2014-06-14T23:13:57.081,JCUBE,0,194,31,163,16,31,20,39,124,194
2014-06-14T22:44:04.509,IMM,1,5,0,5,36,2,30,2,2,5
2014-06-14T22:07:53.74,WESTGATE,2,172,25,147,5,9,23,40,124,172
2014-06-14T21:43:56.702,WESTGATE,1,12,1,11,2,0,41,5,7,12
2014-06-14T21:20:37.928,JEM,0,10,1,9,27,3,20,2,5,10
2014-06-14T20:23:41.959,IMM,0,76,67,9,27,21,3,2,53,76
2014-06-14T19:21:38.838,JCUBE,1,9,0,9,1,0,7,1,8,9
2014-06-14T19:02:45.061,WESTGATE,1,6,4,2,20,1,8,0,4,6
2014-06-14T17:37:44.072,WESTGATE,0,7,3,4,21,1,20,1,4,7
2014-06-14T17:32:53.382,JEM,1,151,47,104,37,56,4,6,89,151
2014-06-14T17:17:30.895,IMM,2,181,10,171,33,60,1,2,120,181
2014-06-14T16:11:18.496,JCUBE,2,105,105,0,36,38,44,46,21,105
2014-06-14T16:03:45.292,WESTGATE,0,87,18,69,13,11,55,48,28,87
2014-06-14T16:03:13.851,IMM,0,221,29,192,10,22,58,128,71,221
2014-06-14T15:49:56.94,JCUBE,1,8,7,1,32,3,8,1,5,8
2014-06-14T15:22:54.342,WESTGATE,1,11,2,9,29,3,35,4,4,11
2014-06-14T15:05:14.162,WESTGATE,2,13,11,2,7,1,4,1,12,13
2014-06-14T14:24:46.85,JCUBE,0,21,19,2,11,2,39,8,11,21
2014-06-14T13:05:57.844,WESTGATE,1,13,4,9,5,1,28,4,9,13
2014-06-14T12:36:36.504,WESTGATE,1,9,5,4,38,3,45,4,1,9
2014-06-14T11:26:42.385,WESTGATE,0,7,2,5,40,3,59,4,0,7
2014-06-14T10:51:17.46,IMM,2,44,25,19,8,4,18,8,33,44
2014-06-14T10:50:23.973,IMM,2,5,1,4,11,1,1,0,4,5
2014-06-14T10:27:12.124,IMM,1,19,5,14,34,6,31,6,7,19
2014-06-14T09:59:30.259,IMM,2,18,9,9,6,1,34,6,11,18
2014-06-14T09:54:50.706,JCUBE,1,68,14,54,33,22,33,22,23,68
2014-06-14T09:47:33.388,IMM,0,10,2,8,32,3,27,3,4,10
2014-06-14T09:39:46.091,JCUBE,1,200,28,172,5,10,29,58,132,200
2014-06-14T09:29:15.618,JEM,2,33,6,27,16,5,13,4,24,33
2014-06-14T09:24:22.567,JCUBE,2,9,2,7,40,4,38,4,2,9
2014-06-14T08:50:02.091,JEM,2,5,3,2,37,2,24,1,2,5
2014-06-14T08:34:10.96,JCUBE,2,5,4,1,24,1,49,2,1,5
2014-06-14T08:03:55.297,IMM,2,133,5,128,24,32,11,15,87,133
2014-06-14T08:02:04.121,JCUBE,1,239,131,108,15,36,6,14,189,239
2014-06-14T07:41:33.912,JEM,0,106,31,75,39,41,56,59,5,106
2014-06-14T07:38:19.63,JCUBE,0,13,9,4,36,5,14,2,6,13
2014-06-14T06:56:31.769,JEM,1,5,5,0,31,2,54,3,1,5
2014-06-14T06:35:56.565,IMM,0,16,14,2,6,1,42,7,8,16
2014-06-14T05:56:23.253,JCUBE,2,5,1,4,17,1,25,1,3,5
2014-06-14T04:22:35.303,IMM,2,5,0,5,38,2,40,2,1,5
2014-06-14T04:20:23.38,JCUBE,1,11,2,9,39,4,39,4,2,11
2014-06-14T03:57:56.005,JEM,0,5,3,2,9,0,58,3,2,5
2014-06-14T03:17:35.023,WESTGATE,0,6,0,6,15,1,25,2,4,6
2014-06-14T01:49:15.271,JEM,2,5,0,5,28,1,24,1,3,5
2014-06-14T01:35:57.888,JEM,2,5,4,1,17,1,18,1,3,5
2014-06-13T23:58:29.937,JCUBE,0,5,4,1,38,2,24,1,2,5
2014-06-13T23:02:22.782,JEM,2,5,0,5,18,1,58,3,1,5
2014-06-13T22:39:50.217,JEM,1,5,0,5,3,0,29,1,3,5
2014-06-13T22:26:36.373,JCUBE,0,10,9,1,18,2,41,4,4,10
2014-06-13T22:19:47.307,JEM,1,17,12,5,40,7,47,8,2,17
2014-06-13T22:17:15.243,WESTGATE,0,5,3,2,12,1,32,2,3,5
2014-06-13T22:06:40.304,JEM,1,6,5,1,19,1,7,0,5,6
2014-06-13T21:44:27.747,JEM,2,19,11,8,24,5,31,6,9,19
2014-06-13T18:14:04.11,JEM,1,15,6,9,12,2,38,6,8,15
2014-06-13T17:27:26.166,IMM,0,464,365,99,14,65,35,162,236,464
2014-06-13T17:16:54.062,WESTGATE,2,5,5,0,7,0,56,3,2,5
2014-06-13T17:13:38.126,WESTGATE,1,5,2,3,4,0,56,3,2,5
2014-06-13T17:06:08.401,WESTGATE,2,156,7,149,2,3,53,83,70,156
2014-06-13T16:59:15.614,JEM,1,136,24,112,4,5,53,72,59,136
2014-06-13T15:45:54.432,JEM,1,207,147,60,23,48,18,37,122,207
2014-06-13T15:18:57.668,JEM,1,6,2,4,26,2,8,0,4,6
2014-06-13T14:39:04.474,WESTGATE,2,13,3,10,35,4,7,1,7,13
2014-06-13T13:51:14.829,WESTGATE,0,40,2,38,25,10,34,14,17,40
2014-06-13T13:39:52.953,IMM,0,13,6,7,35,5,18,2,6,13
2014-06-13T13:20:12.554,JEM,0,169,54,115,17,29,18,30,110,169
2014-06-13T12:49:59.093,JCUBE,1,5,2,3,5,0,34,2,3,5
2014-06-13T11:35:49.889,IMM,0,69,62,7,35,24,42,29,16,69
2014-06-13T11:21:53.142,JEM,0,42,22,20,34,14,10,4,24,42
2014-06-13T10:20:14.274,WESTGATE,2,5,1,4,18,1,5,0,4,5
2014-06-13T09:56:04.092,JEM,2,24,14,10,35,9,54,13,3,24
2014-06-13T08:34:03.205,JCUBE,0,64,63,1,17,11,42,27,26,64
2014-06-13T08:23:33.442,JEM,2,50,31,19,6,3,2,1,46,50
2014-06-13T08:21:14.381,JCUBE,2,125,115,10,35,44,40,50,31,125
2014-06-13T07:58:12.735,IMM,2,5,0,5,37,2,31,2,2,5
2014-06-13T07:26:05.163,JCUBE,0,16,11,5,8,1,20,3,11,16
2014-06-13T05:57:07.718,WESTGATE,0,5,1,4,9,0,10,1,4,5
2014-06-13T04:59:23.627,WESTGATE,2,9,4,5,3,0,52,5,4,9
2014-06-13T04:58:12.958,IMM,0,92,26,66,33,30,4,4,58,92
2014-06-13T04:56:57.424,JEM,2,34,8,26,26,9,29,10,15,34
2014-06-13T04:38:41.359,JCUBE,0,6,4,2,10,1,52,3,2,6
2014-06-13T04:19:56.565,WESTGATE,0,25,20,5,35,9,26,6,10,25
2014-06-13T04:15:35.343,IMM,2,5,4,1,2,0,14,1,4,5
2014-06-13T03:32:17.721,JCUBE,2,8,7,1,6,0,4,0,7,8
2014-06-13T03:29:02.33,JCUBE,0,42,42,0,2,1,12,5,36,42
